"filename", "language", "TypeScript", "CSS", "Vue", "SCSS", "XML", "comment", "blank", "total"
"/Users/zouxinyu/Yuki/my-blog/src/App.vue", "Vue", 0, 0, 83, 0, 0, 7, 16, 106
"/Users/zouxinyu/Yuki/my-blog/src/assets/css/adminCss/adminCommon.css", "CSS", 0, 15, 0, 0, 0, 6, 4, 25
"/Users/zouxinyu/Yuki/my-blog/src/assets/css/adminCss/adminCommon.min.css", "CSS", 0, 1, 0, 0, 0, 0, 1, 2
"/Users/zouxinyu/Yuki/my-blog/src/assets/css/adminCss/adminCommon.scss", "SCSS", 0, 0, 0, 17, 0, 8, 4, 29
"/Users/zouxinyu/Yuki/my-blog/src/assets/css/common.css", "CSS", 0, 1, 0, 0, 0, 0, 0, 1
"/Users/zouxinyu/Yuki/my-blog/src/assets/css/common.min.css", "CSS", 0, 1, 0, 0, 0, 0, 0, 1
"/Users/zouxinyu/Yuki/my-blog/src/assets/css/common.scss", "SCSS", 0, 0, 0, 3, 0, 4, 2, 9
"/Users/zouxinyu/Yuki/my-blog/src/assets/css/homeBack.css", "CSS", 0, 52, 0, 0, 0, 3, 8, 63
"/Users/zouxinyu/Yuki/my-blog/src/assets/css/loadAnime.css", "CSS", 0, 54, 0, 0, 0, 1, 7, 62
"/Users/zouxinyu/Yuki/my-blog/src/assets/img/fontIcon/anchor.svg", "XML", 0, 0, 0, 0, 1, 0, 0, 1
"/Users/zouxinyu/Yuki/my-blog/src/assets/img/fontIcon/androidapp.svg", "XML", 0, 0, 0, 0, 1, 0, 0, 1
"/Users/zouxinyu/Yuki/my-blog/src/assets/img/fontIcon/app.svg", "XML", 0, 0, 0, 0, 1, 0, 0, 1
"/Users/zouxinyu/Yuki/my-blog/src/assets/img/fontIcon/close.svg", "XML", 0, 0, 0, 0, 1, 0, 0, 1
"/Users/zouxinyu/Yuki/my-blog/src/assets/img/fontIcon/dot.svg", "XML", 0, 0, 0, 0, 1, 0, 0, 1
"/Users/zouxinyu/Yuki/my-blog/src/assets/img/fontIcon/heart.svg", "XML", 0, 0, 0, 0, 1, 0, 0, 1
"/Users/zouxinyu/Yuki/my-blog/src/assets/img/fontIcon/iosapp.svg", "XML", 0, 0, 0, 0, 1, 0, 0, 1
"/Users/zouxinyu/Yuki/my-blog/src/assets/img/fontIcon/loginOut.svg", "XML", 0, 0, 0, 0, 1, 0, 0, 1
"/Users/zouxinyu/Yuki/my-blog/src/assets/img/fontIcon/macapp.svg", "XML", 0, 0, 0, 0, 1, 0, 0, 1
"/Users/zouxinyu/Yuki/my-blog/src/assets/img/fontIcon/search.svg", "XML", 0, 0, 0, 0, 1, 0, 0, 1
"/Users/zouxinyu/Yuki/my-blog/src/assets/img/fontIcon/time.svg", "XML", 0, 0, 0, 0, 1, 0, 0, 1
"/Users/zouxinyu/Yuki/my-blog/src/assets/img/fontIcon/vue2.xLogo.svg", "XML", 0, 0, 0, 0, 1, 0, 0, 1
"/Users/zouxinyu/Yuki/my-blog/src/assets/img/fontIcon/vue3.xLogo.svg", "XML", 0, 0, 0, 0, 1, 0, 0, 1
"/Users/zouxinyu/Yuki/my-blog/src/assets/img/fontIcon/webapp.svg", "XML", 0, 0, 0, 0, 1, 0, 0, 1
"/Users/zouxinyu/Yuki/my-blog/src/assets/img/footerImg/sakura.svg", "XML", 0, 0, 0, 0, 25, 0, 0, 25
"/Users/zouxinyu/Yuki/my-blog/src/assets/ts/API.ts", "TypeScript", 2, 0, 0, 0, 0, 7, 2, 11
"/Users/zouxinyu/Yuki/my-blog/src/assets/ts/Regexp.ts", "TypeScript", 4, 0, 0, 0, 0, 6, 2, 12
"/Users/zouxinyu/Yuki/my-blog/src/assets/ts/base64.ts", "TypeScript", 14, 0, 0, 0, 0, 9, 1, 24
"/Users/zouxinyu/Yuki/my-blog/src/assets/ts/canvas.ts", "TypeScript", 93, 0, 0, 0, 0, 12, 10, 115
"/Users/zouxinyu/Yuki/my-blog/src/assets/ts/common.ts", "TypeScript", 69, 0, 0, 0, 0, 46, 15, 130
"/Users/zouxinyu/Yuki/my-blog/src/assets/ts/markdownEditorSet.ts", "TypeScript", 54, 0, 0, 0, 0, 25, 13, 92
"/Users/zouxinyu/Yuki/my-blog/src/assets/ts/yome.ts", "TypeScript", 18, 0, 0, 0, 0, 1, 2, 21
"/Users/zouxinyu/Yuki/my-blog/src/components/adminPage/kanriPage/addPage.vue", "Vue", 0, 0, 421, 0, 0, 79, 51, 551
"/Users/zouxinyu/Yuki/my-blog/src/components/adminPage/kanriPage/appKanriPage.vue", "Vue", 0, 0, 191, 0, 0, 30, 26, 247
"/Users/zouxinyu/Yuki/my-blog/src/components/adminPage/kanriPage/artKanriPage.vue", "Vue", 0, 0, 161, 0, 0, 41, 20, 222
"/Users/zouxinyu/Yuki/my-blog/src/components/adminPage/kanriPage/homePageKanriPage.vue", "Vue", 0, 0, 135, 0, 0, 24, 12, 171
"/Users/zouxinyu/Yuki/my-blog/src/components/adminPage/kanriPage/imgUpLoad.vue", "Vue", 0, 0, 87, 0, 0, 8, 13, 108
"/Users/zouxinyu/Yuki/my-blog/src/components/adminPage/kanriPage/typeClassKanri.vue", "Vue", 0, 0, 6, 0, 0, 0, 1, 7
"/Users/zouxinyu/Yuki/my-blog/src/components/adminPage/kanriPage/userSetPage.vue", "Vue", 0, 0, 214, 0, 0, 32, 35, 281
"/Users/zouxinyu/Yuki/my-blog/src/components/adminPage/sidebar.vue", "Vue", 0, 0, 81, 0, 0, 4, 9, 94
"/Users/zouxinyu/Yuki/my-blog/src/components/appItem/appItem.vue", "Vue", 0, 0, 88, 0, 0, 2, 14, 104
"/Users/zouxinyu/Yuki/my-blog/src/components/backTop/backTop.vue", "Vue", 0, 0, 121, 0, 0, 34, 21, 176
"/Users/zouxinyu/Yuki/my-blog/src/components/backTop/css/kituneMove.css", "CSS", 0, 301, 0, 0, 0, 2, 42, 345
"/Users/zouxinyu/Yuki/my-blog/src/components/banner/2021-haru/bannerHaru.vue", "Vue", 0, 0, 354, 0, 0, 42, 10, 406
"/Users/zouxinyu/Yuki/my-blog/src/components/banner/2021-haru/imageBox.vue", "Vue", 0, 0, 36, 0, 0, 1, 3, 40
"/Users/zouxinyu/Yuki/my-blog/src/components/banner/2021-natu/bannerNatu.vue", "Vue", 0, 0, 81, 0, 0, 23, 10, 114
"/Users/zouxinyu/Yuki/my-blog/src/components/blogFooter/blogFooter.vue", "Vue", 0, 0, 72, 0, 0, 0, 13, 85
"/Users/zouxinyu/Yuki/my-blog/src/components/classPageItem/classPageItem.vue", "Vue", 0, 0, 144, 0, 0, 15, 20, 179
"/Users/zouxinyu/Yuki/my-blog/src/components/contentLine/contentLine.vue", "Vue", 0, 0, 55, 0, 0, 0, 10, 65
"/Users/zouxinyu/Yuki/my-blog/src/components/contentPageItem/contentPageItem.vue", "Vue", 0, 0, 178, 0, 0, 21, 30, 229
"/Users/zouxinyu/Yuki/my-blog/src/components/contentPageItem/contentPageItemTag/contentPageItemTag.vue", "Vue", 0, 0, 35, 0, 0, 0, 6, 41
"/Users/zouxinyu/Yuki/my-blog/src/components/contentTop/contentTop.vue", "Vue", 0, 0, 109, 0, 0, 9, 16, 134
"/Users/zouxinyu/Yuki/my-blog/src/components/home/indexNav.vue", "Vue", 0, 0, 82, 0, 0, 2, 13, 97
"/Users/zouxinyu/Yuki/my-blog/src/components/indexList/indexList.vue", "Vue", 0, 0, 182, 0, 0, 33, 28, 243
"/Users/zouxinyu/Yuki/my-blog/src/components/indexList/indexListItem/indexListItem.vue", "Vue", 0, 0, 20, 0, 0, 1, 7, 28
"/Users/zouxinyu/Yuki/my-blog/src/components/language/language.vue", "Vue", 0, 0, 58, 0, 0, 4, 10, 72
"/Users/zouxinyu/Yuki/my-blog/src/components/nav/topNav.vue", "Vue", 0, 0, 374, 0, 0, 54, 53, 481
"/Users/zouxinyu/Yuki/my-blog/src/components/topLogo/topLogo.vue", "Vue", 0, 0, 91, 0, 0, 8, 13, 112
"/Users/zouxinyu/Yuki/my-blog/src/components/topProgress/topProgress.vue", "Vue", 0, 0, 58, 0, 0, 19, 12, 89
"/Users/zouxinyu/Yuki/my-blog/src/components/viewMore/viewMore.vue", "Vue", 0, 0, 44, 0, 0, 0, 9, 53
"/Users/zouxinyu/Yuki/my-blog/src/main.ts", "TypeScript", 94, 0, 0, 0, 0, 33, 20, 147
"/Users/zouxinyu/Yuki/my-blog/src/plugins/element.ts", "TypeScript", 6, 0, 0, 0, 0, 0, 2, 8
"/Users/zouxinyu/Yuki/my-blog/src/router/adminRouter.ts", "TypeScript", 76, 0, 0, 0, 0, 6, 1, 83
"/Users/zouxinyu/Yuki/my-blog/src/router/homePageRouter.ts", "TypeScript", 67, 0, 0, 0, 0, 6, 2, 75
"/Users/zouxinyu/Yuki/my-blog/src/router/index.ts", "TypeScript", 10, 0, 0, 0, 0, 6, 5, 21
"/Users/zouxinyu/Yuki/my-blog/src/shims-vue.d.ts", "TypeScript", 18, 0, 0, 0, 0, 7, 2, 27
"/Users/zouxinyu/Yuki/my-blog/src/store/index.ts", "TypeScript", 63, 0, 0, 0, 0, 10, 2, 75
"/Users/zouxinyu/Yuki/my-blog/src/views/Home.vue", "Vue", 0, 0, 264, 0, 0, 39, 33, 336
"/Users/zouxinyu/Yuki/my-blog/src/views/adminPage/adminHome.vue", "Vue", 0, 0, 76, 0, 0, 11, 11, 98
"/Users/zouxinyu/Yuki/my-blog/src/views/adminPage/testPage.vue", "Vue", 0, 0, 69, 0, 0, 0, 3, 72
"/Users/zouxinyu/Yuki/my-blog/src/views/application.vue", "Vue", 0, 0, 144, 0, 0, 13, 19, 176
"/Users/zouxinyu/Yuki/my-blog/src/views/classPage.vue", "Vue", 0, 0, 220, 0, 0, 19, 23, 262
"/Users/zouxinyu/Yuki/my-blog/src/views/contentPage.vue", "Vue", 0, 0, 294, 0, 0, 90, 40, 424
"/Users/zouxinyu/Yuki/my-blog/src/views/searchPage.vue", "Vue", 0, 0, 220, 0, 0, 19, 23, 262
"/Users/zouxinyu/Yuki/my-blog/src/views/senPage.vue", "Vue", 0, 0, 126, 0, 0, 17, 19, 162
"/Users/zouxinyu/Yuki/my-blog/src/views/templatePage.vue", "Vue", 0, 0, 36, 0, 0, 4, 9, 49
"Total", "-", 588, 425, 5010, 20, 39, 903, 808, 7793